NO textures/Grey_Brick.xpm
SO textures/Grey_Brick.xpm
WE textures/Grey_Brick.xpm
EA textures/Grey_Brick.xpm

F 148, 114, 19

1111111
11N0001
1111111